10,10,10,10,10,10,10,10,10,10
10,09,17,13,09,17,10,09,09,09
09,09,17,13,09,17,10,09,09,18
10,09,16,14,09,16,15,09,18,22
10,09,09,09,00,00,03,09,16,15
11,09,09,09,00,00,03,09,00,00
10,09,09,10,10,09,09,09,00,00
10,09,09,09,09,09,09,09,09,09
10,10,10,10,10,10,11,11,11,11
10,10,10,10,10,10,10,10,10,10
